algorithm: backtracking
width: 21
height: 21
start: side 3, relative 0.5
end: side 3, relative 0.25
[
  [
    1, 1, 1, 1, 1, 0, 1,
    1, 1, 0, 1, 1, 1, 1,
    1, 1, 1, 1, 1, 1, 1
  ],
  [
    1, 0, 0, 0, 0, 0, 1,
    0, 0, 0, 0, 0, 0, 0,
    0, 0, 1, 0, 0, 0, 1
  ],
  [
    1, 0, 1, 1, 1, 0, 1,
    0, 1, 1, 1, 1, 1, 1,
    1, 0, 1, 1, 1, 0, 1
  ],
  [
    1, 0, 1, 0, 1, 0, 0,
    0, 1, 0, 0, 0, 0, 0,
    1, 0, 0, 0, 0, 0, 1
  ],
  [
    1, 0, 1, 0, 1, 1, 1,
    1, 1, 0, 1, 1, 1, 0,
    1, 1, 1, 1, 1, 0, 1
  ],
  [
    1, 0, 1, 0, 0, 0, 0,
    0, 0, 0, 1, 0, 0, 0,
    1, 0, 0, 0, 1, 0, 1
  ],
  [
    1, 0, 1, 1, 1, 0, 1,
    0, 1, 1, 1, 0, 1, 1,
    1, 0, 1, 0, 1, 0, 1
  ],
  [
    1, 0, 0, 0, 1, 0, 1,
    0, 1, 0, 0, 0, 0, 0,
    1, 0, 1, 0, 0, 0, 1
  ],
  [
    1, 0, 1, 0, 1, 1, 1,
    0, 1, 0, 1, 1, 1, 1,
    1, 0, 1, 1, 1, 1, 1
  ],
  [
    1, 0, 1, 0, 0, 0, 1,
    0, 1, 0, 0, 0, 1, 0,
    0, 0, 1, 0, 0, 0, 1
  ],
  [
    1, 0, 1, 1, 1, 0, 1,
    0, 1, 1, 1, 1, 1, 0,
    1, 1, 1, 1, 1, 0, 1
  ],
  [
    1, 0, 1, 0, 1, 0, 1,
    0, 0, 0, 0, 0, 0, 0,
    1, 0, 0, 0, 0, 0, 1
  ],
  [
    1, 0, 1, 0, 1, 0, 1,
    0, 1, 1, 1, 1, 1, 1,
    1, 1, 1, 0, 1, 0, 1
  ],
  [
    1, 0, 0, 0, 1, 0, 1,
    0, 1, 0, 0, 0, 1, 0,
    0, 0, 0, 0, 1, 0, 1
  ],
  [
    1, 1, 1, 1, 1, 0, 1,
    0, 1, 0, 1, 0, 1, 0,
    1, 1, 1, 1, 1, 1, 1
  ],
  [
    1, 0, 0, 0, 0, 0, 1,
    0, 1, 0, 1, 0, 1, 0,
    1, 0, 0, 0, 0, 0, 1
  ],
  [
    1, 0, 1, 1, 1, 1, 1,
    0, 1, 0, 1, 0, 1, 0,
    1, 0, 1, 1, 1, 0, 1
  ],
  [
    1, 0, 0, 0, 1, 0, 1,
    0, 0, 0, 1, 0, 1, 0,
    0, 0, 0, 0, 1, 0, 1
  ],
  [
    1, 0, 1, 0, 1, 0, 1,
    1, 1, 1, 1, 0, 1, 1,
    1, 1, 1, 1, 1, 0, 1
  ],
  [
    1, 0, 1, 0, 1, 0, 0,
    0, 0, 0, 0, 0, 0, 0,
    0, 0, 0, 0, 0, 0, 1
  ],
  [
    1, 1, 1, 1, 1, 1, 1,
    1, 1, 1, 1, 1, 1, 1,
    1, 1, 1, 1, 1, 1, 1
  ]
]
